######################################################
#....................................................#
#....................................................#
#....................................................#
#....................................................#
#....................................................#
#....................................................#
#....................................................#
#....................................................#
#....................................................#
#....................................................#
#....................................................#
#################...##########.......................#
#...........................##.......................#
#..#######################..##.......................#
#..##...................##..##.......................#
#..##...................##..##.......................#
#..##...................##..##.......................#
#..##...................##..##.......................#
#..##.......................##.......................#
#..######...................##.......................#
#.......##########..........##.......................#
#................#..........##.......................#
#................#..........##.......................#
######################################################
