######################################################
#....................................................#
#....................................................#
#....................................................#
#......#...............................#######.......#
#......#...............................#######.......#
#......#...............................##....#.......#
#......#########################.......##....#.......#
#..............................#.......##....#.......#
#..............................#.......##....#.......#
#..............................#.......##....#.......#
################################.......##....#.......#
#......................................##....#.......#
#......................................##....#.......#
#..#######################..#############....#.......#
#..##...................##..##..........#....#.......#
#..##...................##..##..........#....##......#
#..##...................##..##..........#............#
#..##...................##..##..........#............#
#..##.......................##..........#............#
#..######...................##..........#######......#
#.......##########..........##.......................#
#................#..........##.......................#
#................#..........##.......................#
######################################################
